{
    "maze": {
        "map":[
                [1, 1, 1, 1, 1, 1, 1, 1, 1, 1, 1, 1], 
                [1, 0, 0, 0, 0, 1, 0, 0, 0, 0, 0, 1], 
                [1, 0, 1, 1, 0, 1, 0, 1, 0, 1, 0, 1], 
                [1, 0, 0, 0, 0, 0, 0, 1, 0, 0, 0, 1], 
                [1, 0, 1, 1, 1, 1, 0, 1, 1, 1, 0, 1], 
                [1, 0, 0, 1, 0, 1, 0, 0, 0, 0, 0, 1], 
                [1, 1, 0, 1, 0, 1, 0, 1, 0, 1, 1, 1], 
                [1, 0, 0, 1, 0, 0, 0, 1, 0, 0, 0, 1], 
                [1, 1, 1, 1, 1, 1, 1, 1, 1, 1, 1, 1]
            ],
        "start": [
            1,
            1
        ],
        "goal": [
            7,
            10
        ]
    },
    "sample_args": {
        "starts": [
            [
                1,
                1
            ]
        ],
        "goals": [
            [
                7,
                10
            ]
        ],
        "repeats": [
            1000
        ],
        "randoms": [
            true
        ]
    }
}